##########
#........#
#..##....#
#........#
#........#
#..##....#
#........#
#........#
#........#
#........#
#..##....#
#........#
##########



